∎ ∎ ∎ ∎ ∎
∎ . O g O
∎ p . . .
∎ . . . .
∎ ∎ ∎ ∎ ∎
