g . . O ⓖ g
∎ O . . ∎ ∎
∎ O . r ∎ ∎
∎ ∎ ∎ ∎ ∎ ∎
∎ ∎ ∎ ∎ ∎ ∎
∎ ∎ ∎ ∎ ∎ ∎