∎ ∎ . g ∎ ∎
∎ ∎ . O ∎ ∎
g O O O . ⓖ
. . . . . .
∎ ∎ r p ∎ ∎
∎ ∎ ∎ ∎ ∎ ∎